15 29 
###############
#*........#...#
###.###.###.#.#
#...#...#...#.#
#.#####.#####.#
#.....#...#...#
#.###.#.###.###
#.#...#.#...#.#
#.#.###.#.###.#
#.#.#.#.#.#...#
###.#.#.#.#.#.#
#...#...#.#.#.#
#.#######.#.#.#
#...........#.#