7 5
#######
#.o...#
#####.#
#*....#
#######