29 15 
#############################
#*........#...#.........#...#
###.###.###.#.###.###.###.#.#
#...#...#...#.#...#...#...#.#
#.#####.#####.#.#####.#####.#
#.....#...#...#.....#...#...#
#.###.#.###.###.###.#.###.###
#.#...#.#...#...#...#.#...#.#
#.#.###.#.###.#.#.###.#.###.#
#.#.#.#.#.#...#.#.#.#.#.#...#
###.#.#.#.#.#.###.#.#.#.#.#.#
#...#...#.#.#.#...#...#.#.#.#
#.#######.#.#.#.#######.#.#.#
#...........#.#...........#o#
#############################